R   12000   600
NO textures/barrel.xpm  
SO textures/barrel.xpm
WE textures/barrel.xpm
EA textures/bluestone.xpm
S textures/barrel.xpm

F 0,0,0
C 225,30,0

111111111111111111111111
100020000000000010000001
100000000000000000000001
102222220000000000000001
102222220000000000000001
102222222111100000000001
100000001   100000000001
100020001   100000000001
100000001111100000000001
100020000000000000000001
100000000000000000000001
100000000000000000000001
100000000000000000000001
1000000000000000000000011
1000000000000000000000001
1000000000000000000000011
100000000000000000000001
100000000000000000000001
100000000000000000000001
100000000000000000000001
100000000000000000000001
100002000020000002000001
100000000000000000000S01
111111111111111111111111111112