R    640 480
NO    textures/colorbrick.xpm   
SO textures/bluestone.xpm
WE textures/wood.xpm
EA textures/greystone.xpm
S textures/barrel.xpm
F 220,  100,0
C 225,30,0

111111111111111111111111
100020000000000010000001
100000000000000000000001
100000000000000000000001
10000N000000000000000001
100020001111100000000001
100000001   100000000001
100020001   100000000001
100000001111100000000001
100020000000000000000001
100000000000000000000001
100000000000000000000001
100000000000000000000001
100000000000000000000001
100000000000000000000001
100000000000000000000001
100000000000000000000001
100000000000000000000001
100000000000000000000001
100000000000000000000001
100000000000000000000001
100002000020000002000001
100000000000000000000001
111111111111111111111111

  